S . # # # # # # # # . . . . # # # # # # # # # # # # . # . # # # . . . . .
# . . . . . . . . . . # # . . . . . . . . . . . # . # . # . . . . # # # .
# # # . # # # # # . # . . . # . # # # # # # # . # # . # # # # . # . . . #
. . . . . . . . . . # . # # # . . . . . . . . . . . . . . . # . # . # . #
# # # . # . # # # . . . . . # # # # # . # # # . # # # . # # . # # . # . #
. . . . # . . . . . . . . . . . . . . . . . . # . . . . . . . . . . . . #
# . # . # # # . # # # . # # # # # . # # # # # # . # # . # # # # # . # . #
. . # . . . . . # . . . . . . . # . . . . . . . . . . # . . . . . . # . #
# . # # # # . # # . # # # # # # # . # # # # # . # . # # . # # . # # # . #
. . . . . # . . . . # . . . . . . # . . . . # . # . . . . . # . . . . . #
# # . # . # # . # # # . # # # . # # . # # # # . # # . # . # # . # . # # #
# . . . . . . . . . # . . . . . . . . . . . . . . # . # . . . . . # . . #
. . . # # # # # . # # . # # # . # # # # # . # . . # # . . # . # # . # . #
. # . . . . . . . . . . # . . . . . . . . . # . . . . # . . . . # . # . #
# # # # . # # . # . # # . . . . # # # # # # . . . . . . # # # . . . # . #
. . . . . # . . . . . . . # . . # . . . . . # # . # . . # . . # # # . # #
. # # # . # # # . # . # # # . # # # . # # . # . . # . . # . . . . . . . #
# . . . . . . . . . . . . . . . . . # . . . . . . # # . . . . # # . # # #
. # . # # # # . # # # . # # . # . # # . # . . # # . # . # # # . # . # . #
. # . . . . # . . . . . # . . # . . . . # . . # . . . # . . . . # . . . #
# # . # # . # # . # . # . # # . . . . . . # . # . # . # # # . # # . # . #
. . . # . . . . . # . . . . . . . . # . . . . # . # . # . . . . . . . . #
. # # . # # # . # . # # # . # # # # # . # # # . # # . . . . # # # . # . #
. # . . . . . . . . . . # . . . . . . . . . . # . . . # # # . . . . # . #
# # # # . # # . # # . # . # . # # # # . # # . # . # . . . . . . # . # . #
. . . . . . . . . . . . . . . . . . . . . . . . . . # # # # . # . . . . #
. # # . # # # . # # . # # # . # . # # # . # # . # . . . . . . . . . # # #
. . . . . . . . . . . . . . # . # . . . . . . # # . # # # . # # # . . . #
# . # # . # . # # . # # # . # . . . . . . . . . . . . . # . . . . . . . #
. . . . . . . . . . # . . . # # # # # . # # . # # # . # # . # # # # # . #
. # # # # # # . # # . . . . . . . . . # . . . . . . . . . . . . . . . . #
. . . . . . . . . . # . # # # # . # # . . . # # . # # # . # # . # . # # #
# # . # . # . # . . . . . . . . . . . . . . . . . . . . . . . . . . . . G
